Stage 1
#####
#PoO#
#####
=====
Stage 2
#######
#Oo   #
#  P  #
#   oO#
#######
=====
Stage 3
#########
##O    ##
#  #  o##
#     o #
#O##   P#
#########
=====
Stage 4
#######
###P ##
## oo #
# O # #
#O Oo #
##    #
#######
=====
Stage 5
########
##   O##
# o  o #
#  # #P#
#  # oO#
#O    ##
########